111111101111111
111111101111111
111111101111111
111111101111111
111111101111111
111111101111111
111111100000001
111111111111101
111111111111101